-22
23
-10
13
0000000000000000000000000000000000000000000000
1111111111111111111111111111111111111111111110
0000000000000000000000000000000000000000000000
0000000000000000000000000000000000000000000000
0000000000000000000000000000000000000000000000
0000000000000000000000000000000000000000000000
0000000000000000000000000000000000000000000000
0000000000000000000000000000000000000000000000
0000000000000000000000000000000000000000000000
0000000000000000000000000000000011000000000000
0000000000000000000000000111111100000000000000
0000000000010000000000000111111100000000000000
0000000000000000000000000111111100000000000000
0000000000000100000000000111111100000000000000
0000000000000000000000000111111100000000000000
0000000000000000000000000111111100000000000000
0000000000000000000000000111111100000000000000
0000000000000000000000000000000000000000000000
0000000000000000000000000000000000000000000000
0000000000000000000000000000000000000000000000
0000000000000000000000000000000000000000000000
0000000000000000000000000000000000000000000000
0000000000000000000000000000000000000000000000
0000000000000000000000000000000000000000000000
